//MAP CONVERTED BY dmm2tgm.py THIS HEADER COMMENT PREVENTS RECONVERSION, DO NOT REMOVE
"c" = (
/turf/open/floor/plating/asteroid/sand/sand_land_surface,
/area/sandland/surface/outdoors/unexplored)
"k" = (
/obj/item/pickaxe,
/turf/open/floor/plating/asteroid/sand/sand_land_surface,
/area/sandland/surface/outdoors/unexplored)
"l" = (
/obj/structure/geyser/random,
/turf/open/floor/plating/asteroid/sand/sand_land_surface,
/area/sandland/surface/outdoors/unexplored)
"n" = (
/obj/effect/mob_spawn/human/corpse/cargo_tech,
/turf/open/floor/plating/asteroid/sand/sand_land_surface,
/area/sandland/surface/outdoors/unexplored)
"o" = (
/obj/item/stack/ore/iron,
/turf/open/floor/plating/asteroid/sand/sand_land_surface,
/area/sandland/surface/outdoors/unexplored)
"p" = (
/turf/closed/mineral/random/high_chance,
/area/sandland/surface/outdoors/unexplored)
"s" = (
/turf/closed/mineral/random/low_chance,
/area/sandland/surface/outdoors/unexplored)
"t" = (
/obj/structure/flora/rock,
/turf/open/floor/plating/asteroid/sand/sand_land_surface,
/area/sandland/surface/outdoors/unexplored)
"x" = (
/obj/item/clothing/under/color/random,
/turf/open/floor/plating/asteroid/sand/sand_land_surface,
/area/sandland/surface/outdoors/unexplored)
"z" = (
/obj/structure/flora/rock/pile,
/turf/open/floor/plating/asteroid/sand/sand_land_surface,
/area/sandland/surface/outdoors/unexplored)
"K" = (
/obj/structure/statue/sandstone/assistant,
/turf/open/floor/plating/asteroid/sand/sand_land_surface,
/area/sandland/surface/outdoors/unexplored)
"Y" = (
/turf/closed/mineral/random/high_chance/volcanic,
/area/sandland/surface/outdoors/unexplored)

(1,1,1) = {"
c
c
c
c
c
c
c
c
c
c
c
Y
Y
Y
Y
c
c
"}
(2,1,1) = {"
t
c
c
c
c
c
c
c
c
Y
Y
Y
Y
c
c
c
c
"}
(3,1,1) = {"
c
c
c
c
c
c
c
c
c
Y
Y
Y
c
c
c
c
c
"}
(4,1,1) = {"
c
c
c
c
c
z
c
c
p
p
p
c
c
c
c
c
c
"}
(5,1,1) = {"
c
c
c
Y
c
c
c
p
p
p
o
c
c
c
c
c
c
"}
(6,1,1) = {"
c
Y
Y
Y
c
c
Y
k
c
c
c
c
z
c
c
c
c
"}
(7,1,1) = {"
c
c
Y
c
c
c
c
c
c
c
c
c
c
c
c
c
c
"}
(8,1,1) = {"
c
Y
c
c
c
c
c
c
K
c
c
c
c
c
c
c
c
"}
(9,1,1) = {"
c
Y
c
c
c
c
c
c
c
c
c
l
c
s
c
c
c
"}
(10,1,1) = {"
c
Y
Y
c
c
c
t
c
c
c
c
c
c
c
c
s
c
"}
(11,1,1) = {"
c
c
c
c
s
c
c
c
n
p
p
c
c
c
c
c
c
"}
(12,1,1) = {"
c
c
c
c
c
c
c
c
x
p
p
c
c
t
c
c
c
"}
(13,1,1) = {"
c
z
c
c
c
c
c
c
p
c
c
c
c
c
s
c
c
"}
(14,1,1) = {"
c
c
c
c
c
c
c
c
c
c
c
c
c
c
c
c
c
"}
(15,1,1) = {"
c
c
c
c
c
c
c
c
c
c
c
c
c
c
c
c
c
"}
