//MAP CONVERTED BY dmm2tgm.py THIS HEADER COMMENT PREVENTS RECONVERSION, DO NOT REMOVE
"a" = (
/turf/open/floor/plating/asteroid/sand/sand_land_surface,
/area/sandland/surface/outdoors/unexplored)
"d" = (
/turf/closed/mineral,
/area/sandland/surface/outdoors/unexplored)
"f" = (
/turf/closed/mineral/random/high_chance,
/area/sandland/surface/outdoors/unexplored)
"g" = (
/turf/closed/mineral/bananium,
/area/sandland/surface/outdoors/unexplored)
"h" = (
/turf/open/floor/plating/asteroid/airless,
/area/sandland/surface/outdoors/unexplored)
"i" = (
/mob/living/simple_animal/hostile/retaliate/poison/snake,
/turf/open/floor/plating/asteroid/sand/sand_land_surface,
/area/sandland/surface/outdoors/unexplored)
"k" = (
/turf/closed/wall/mineral/titanium,
/area/sandland/surface/outdoors/unexplored)
"m" = (
/obj/structure/chair{
	dir = 1
	},
/obj/item/shard,
/obj/effect/mob_spawn/human/clown{
	brute_damage = 120;
	oxy_damage = 75
	},
/obj/item/paper/fluff/ruins/asteroid4/extraction,
/obj/item/stack/sheet/mineral/bananium{
	amount = 15
	},
/obj/item/stack/sheet/mineral/bananium{
	amount = 15
	},
/turf/open/floor/mineral/titanium/blue,
/area/sandland/surface/outdoors/unexplored)
"n" = (
/obj/structure/chair{
	dir = 1
	},
/obj/item/storage/pod{
	pixel_x = -26
	},
/obj/item/clothing/shoes/sandal,
/turf/open/floor/mineral/titanium/blue,
/area/sandland/surface/outdoors/unexplored)
"o" = (
/obj/structure/shuttle/engine/propulsion/burst,
/turf/closed/wall/mineral/titanium/overspace,
/area/sandland/surface/outdoors/unexplored)
"p" = (
/obj/machinery/door/airlock/titanium{
	name = "Escape Pod Airlock"
	},
/turf/open/floor/mineral/titanium/blue,
/area/sandland/surface/outdoors/unexplored)
"t" = (
/obj/effect/decal/cleanable/blood/old,
/turf/open/floor/plating/asteroid/sand/sand_land_surface,
/area/sandland/surface/outdoors/unexplored)
"F" = (
/obj/structure/flora/rock,
/turf/open/floor/plating/asteroid/sand/sand_land_surface,
/area/sandland/surface/outdoors/unexplored)
"L" = (
/obj/structure/flora/rock/pile,
/turf/open/floor/plating/asteroid/sand/sand_land_surface,
/area/sandland/surface/outdoors/unexplored)
"Q" = (
/mob/living/simple_animal/hostile/asteroid/basilisk,
/turf/open/floor/plating/asteroid/airless,
/area/sandland/surface/outdoors/unexplored)

(1,1,1) = {"
a
f
f
d
d
a
a
a
a
a
a
a
a
a
d
d
a
a
"}
(2,1,1) = {"
d
f
f
d
h
a
a
a
a
a
a
a
d
d
d
d
a
a
"}
(3,1,1) = {"
d
f
f
d
Q
h
a
F
a
a
d
d
d
d
d
a
a
d
"}
(4,1,1) = {"
d
d
d
d
d
h
h
a
a
a
a
a
d
d
d
a
a
a
"}
(5,1,1) = {"
a
d
d
d
d
d
h
a
a
a
a
a
a
a
a
a
d
a
"}
(6,1,1) = {"
a
d
f
f
d
d
h
h
a
a
L
a
a
a
a
a
a
a
"}
(7,1,1) = {"
a
d
d
f
d
d
h
h
a
a
a
a
a
a
a
a
a
a
"}
(8,1,1) = {"
a
a
d
d
f
d
d
d
a
a
a
a
h
h
h
a
F
a
"}
(9,1,1) = {"
a
a
d
d
d
d
F
a
a
a
a
d
d
h
h
a
a
a
"}
(10,1,1) = {"
a
a
a
d
f
f
a
a
a
a
d
d
d
d
d
d
a
a
"}
(11,1,1) = {"
a
a
L
a
a
a
a
a
a
a
d
f
d
k
k
k
o
a
"}
(12,1,1) = {"
a
a
a
a
a
a
a
a
a
f
f
g
t
k
m
n
p
a
"}
(13,1,1) = {"
a
a
a
a
a
a
a
a
a
f
f
f
i
k
k
k
o
a
"}
(14,1,1) = {"
a
a
a
a
a
a
d
d
f
d
d
f
f
d
d
d
a
a
"}
(15,1,1) = {"
a
a
a
d
d
d
d
d
d
d
a
a
f
f
d
a
a
a
"}
(16,1,1) = {"
a
a
d
d
d
d
d
a
a
a
a
a
a
a
a
L
a
a
"}
(17,1,1) = {"
a
F
a
a
d
a
a
a
a
a
a
a
a
a
a
a
a
a
"}
