//MAP CONVERTED BY dmm2tgm.py THIS HEADER COMMENT PREVENTS RECONVERSION, DO NOT REMOVE
"b" = (
/turf/open/floor/plating/asteroid/sand/sand_land_surface,
/area/sandland/surface/outdoors/unexplored)
"c" = (
/turf/closed/mineral,
/area/sandland/surface/outdoors/unexplored)
"d" = (
/turf/closed/mineral/random/high_chance,
/area/sandland/surface/outdoors/unexplored)
"p" = (
/obj/structure/flora/rock/pile,
/turf/open/floor/plating/asteroid/sand/sand_land_surface,
/area/sandland/surface/outdoors/unexplored)
"v" = (
/obj/structure/flora/rock,
/turf/open/floor/plating/asteroid/sand/sand_land_surface,
/area/sandland/surface/outdoors/unexplored)
"I" = (
/obj/item/toy/plush/snakeplushie,
/turf/open/floor/plating/asteroid/sand/sand_land_surface,
/area/sandland/surface/outdoors/unexplored)

(1,1,1) = {"
b
b
b
b
b
b
b
b
b
b
b
b
b
b
b
b
b
b
"}
(2,1,1) = {"
b
b
p
b
b
b
b
b
b
b
b
v
b
b
b
b
b
b
"}
(3,1,1) = {"
b
b
b
b
b
b
b
b
b
b
b
b
b
b
b
b
b
b
"}
(4,1,1) = {"
b
b
b
b
b
b
b
b
b
I
b
b
b
b
b
b
b
b
"}
(5,1,1) = {"
b
b
b
b
c
c
c
b
b
b
b
b
b
b
b
v
b
b
"}
(6,1,1) = {"
b
b
b
b
c
c
c
c
b
b
b
p
b
b
b
b
b
b
"}
(7,1,1) = {"
b
b
b
c
c
c
c
c
b
b
b
b
b
b
b
b
b
b
"}
(8,1,1) = {"
b
b
c
c
c
c
d
c
c
c
c
c
c
b
b
b
b
b
"}
(9,1,1) = {"
b
b
b
c
c
c
d
c
c
c
c
d
d
d
c
b
b
b
"}
(10,1,1) = {"
b
b
b
b
c
c
d
d
c
c
d
d
c
c
c
b
b
b
"}
(11,1,1) = {"
b
b
b
b
c
c
c
d
d
d
d
d
c
c
c
b
b
b
"}
(12,1,1) = {"
b
b
b
b
d
d
c
d
d
d
d
c
c
c
d
c
b
b
"}
(13,1,1) = {"
b
b
b
b
d
d
d
c
c
c
c
c
c
c
c
c
b
b
"}
(14,1,1) = {"
b
b
b
b
b
b
b
c
c
c
c
c
c
d
c
c
c
b
"}
(15,1,1) = {"
v
b
b
b
b
b
b
c
d
c
c
d
d
d
c
c
c
b
"}
(16,1,1) = {"
b
b
b
b
b
b
b
b
b
c
c
d
d
d
b
b
b
b
"}
(17,1,1) = {"
b
b
b
b
b
b
b
b
b
b
b
b
b
b
b
b
p
b
"}
(18,1,1) = {"
b
b
b
b
b
p
b
b
b
b
b
b
b
b
b
b
b
b
"}
(19,1,1) = {"
b
b
b
b
b
b
b
b
b
b
v
b
b
b
b
b
b
b
"}
(20,1,1) = {"
b
b
b
b
b
b
b
b
b
b
b
b
b
b
b
b
b
b
"}
