//MAP CONVERTED BY dmm2tgm.py THIS HEADER COMMENT PREVENTS RECONVERSION, DO NOT REMOVE
"a" = (
/obj/structure/flora/rock,
/turf/open/floor/plating/asteroid/sand/sand_land_surface,
/area/sandland/surface/outdoors/unexplored)
"c" = (
/turf/closed/mineral,
/area/sandland/surface/outdoors/unexplored)
"d" = (
/turf/closed/mineral/random/high_chance,
/area/sandland/surface/outdoors/unexplored)
"e" = (
/turf/open/floor/plating/asteroid/sand/sand_land_surface,
/area/sandland/surface/outdoors/unexplored)
"f" = (
/obj/item/pickaxe/diamond,
/turf/open/floor/plating/asteroid/sand/sand_land_surface,
/area/sandland/surface/outdoors/unexplored)
"B" = (
/obj/item/stack/sheet/mineral/diamond,
/turf/open/floor/plating/asteroid/sand/sand_land_surface,
/area/sandland/surface/outdoors/unexplored)
"D" = (
/obj/item/stack/marker_beacon,
/turf/open/floor/plating/asteroid/sand/sand_land_surface,
/area/sandland/surface/outdoors/unexplored)
"F" = (
/obj/structure/flora/rock/pile,
/turf/open/floor/plating/asteroid/sand/sand_land_surface,
/area/sandland/surface/outdoors/unexplored)
"H" = (
/obj/item/stack/marker_beacon/ten,
/turf/open/floor/plating/asteroid/sand/sand_land_surface,
/area/sandland/surface/outdoors/unexplored)
"R" = (
/obj/item/storage/toolbox/mechanical/old,
/turf/open/floor/plating/asteroid/sand/sand_land_surface,
/area/sandland/surface/outdoors/unexplored)
"U" = (
/obj/item/stack/sheet/mineral/wood,
/turf/open/floor/plating/asteroid/sand/sand_land_surface,
/area/sandland/surface/outdoors/unexplored)
"Y" = (
/obj/effect/decal/remains/human,
/turf/open/floor/plating/asteroid/sand/sand_land_surface,
/area/sandland/surface/outdoors/unexplored)

(1,1,1) = {"
a
e
e
e
e
e
e
e
e
c
c
c
c
e
e
e
e
e
"}
(2,1,1) = {"
e
e
e
e
e
e
e
F
e
d
d
c
c
c
c
c
e
e
"}
(3,1,1) = {"
e
e
e
e
e
e
e
e
e
d
d
c
c
d
d
d
e
e
"}
(4,1,1) = {"
e
e
e
e
c
c
e
e
c
d
d
c
c
d
d
d
e
e
"}
(5,1,1) = {"
e
e
c
c
c
c
c
c
c
c
c
c
c
d
d
d
c
e
"}
(6,1,1) = {"
e
e
c
c
c
d
d
c
c
c
e
c
c
c
c
c
e
e
"}
(7,1,1) = {"
e
e
e
e
c
d
c
c
U
e
e
e
c
c
c
c
e
e
"}
(8,1,1) = {"
e
e
e
c
c
c
c
B
e
e
f
e
e
c
c
e
e
e
"}
(9,1,1) = {"
e
e
e
c
c
c
c
e
e
e
e
e
e
c
c
c
e
e
"}
(10,1,1) = {"
e
e
e
c
c
Y
H
e
e
e
e
F
c
c
c
c
c
e
"}
(11,1,1) = {"
e
e
e
c
c
c
c
c
R
e
c
c
c
c
d
d
e
e
"}
(12,1,1) = {"
e
F
e
d
d
c
c
c
c
d
d
d
c
c
d
d
e
e
"}
(13,1,1) = {"
e
e
e
d
d
c
c
c
d
d
d
c
c
c
c
e
e
e
"}
(14,1,1) = {"
e
e
e
d
d
c
c
c
d
d
c
c
c
e
e
e
e
e
"}
(15,1,1) = {"
e
e
e
c
c
c
c
c
c
c
c
c
c
e
e
e
a
e
"}
(16,1,1) = {"
e
e
e
e
e
c
c
c
c
c
c
e
e
e
e
e
e
e
"}
(17,1,1) = {"
e
e
e
e
e
c
c
d
d
c
c
e
e
F
e
D
e
e
"}
(18,1,1) = {"
e
e
e
a
e
e
c
d
d
e
e
e
e
e
e
e
e
e
"}
(19,1,1) = {"
e
e
e
e
e
e
e
e
e
e
e
e
e
e
e
e
e
e
"}
