//MAP CONVERTED BY dmm2tgm.py THIS HEADER COMMENT PREVENTS RECONVERSION, DO NOT REMOVE
"b" = (
/turf/closed/mineral,
/area/sandland/surface/outdoors/unexplored)
"c" = (
/turf/closed/mineral/random/high_chance,
/area/sandland/surface/outdoors/unexplored)
"d" = (
/turf/open/floor/plating/asteroid/sand/sand_land_surface,
/area/sandland/surface/outdoors/unexplored)
"e" = (
/obj/structure/reagent_dispensers/plumbed,
/turf/open/floor/plating/asteroid/sand/sand_land_surface,
/area/sandland/surface/outdoors/unexplored)
"f" = (
/obj/structure/flora/rock/pile,
/turf/open/floor/plating/asteroid/sand/sand_land_surface,
/area/sandland/surface/outdoors/unexplored/danger)
"h" = (
/obj/structure/mineral_door/sandstone,
/turf/open/floor/plating/asteroid/sand/sand_land_surface,
/area/sandland/surface/outdoors/unexplored)
"i" = (
/obj/item/stack/sheet/mineral/uranium{
	amount = 7
	},
/turf/open/floor/plating/asteroid/sand/sand_land_surface,
/area/sandland/surface/outdoors/unexplored)
"j" = (
/obj/item/shovel,
/obj/structure/spider/stickyweb,
/turf/open/floor/plating/asteroid/sand/sand_land_surface,
/area/sandland/surface/outdoors/unexplored)
"k" = (
/obj/structure/flora/rock/pile,
/turf/open/floor/plating/asteroid/sand/sand_land_surface,
/area/sandland/surface/outdoors/unexplored)
"l" = (
/obj/item/trash/can/food/beans{
	pixel_x = -4
	},
/turf/open/floor/plating/asteroid/sand/sand_land_surface,
/area/sandland/surface/outdoors/unexplored)
"m" = (
/obj/structure/flora/rock,
/turf/open/floor/plating/asteroid/sand/sand_land_surface,
/area/sandland/surface/outdoors/unexplored/danger)
"n" = (
/obj/item/reagent_containers/food/snacks/egg/green,
/turf/open/floor/plating/asteroid/sand/sand_land_surface,
/area/sandland/surface/outdoors/unexplored/danger)
"o" = (
/obj/item/stack/sheet/mineral/copper{
	amount = 26
	},
/obj/structure/spider/stickyweb,
/turf/open/floor/plating/asteroid/sand/sand_land_surface,
/area/sandland/surface/outdoors/unexplored)
"p" = (
/obj/structure/spider/spiderling,
/turf/open/floor/plating/asteroid/sand/sand_land_surface,
/area/sandland/surface/outdoors/unexplored)
"r" = (
/obj/structure/sign/warning,
/turf/closed/wall/mineral/sandstone,
/area/sandland/surface/outdoors/unexplored)
"v" = (
/obj/structure/flora/rock,
/turf/open/floor/plating/asteroid/sand/sand_land_surface,
/area/sandland/surface/outdoors/unexplored)
"x" = (
/turf/closed/wall/mineral/sandstone,
/area/sandland/surface/outdoors/unexplored)
"z" = (
/obj/structure/spider/stickyweb,
/turf/open/floor/plating/asteroid/sand/sand_land_surface,
/area/sandland/surface/outdoors/unexplored)
"B" = (
/mob/living/simple_animal/hostile/poison/giant_spider/hunter{
	health = 60
	},
/turf/open/floor/plating/asteroid/sand/sand_land_surface,
/area/sandland/surface/outdoors/unexplored)
"C" = (
/mob/living/simple_animal/hostile/retaliate/poison/snake,
/turf/open/floor/plating/asteroid/sand/sand_land_surface,
/area/sandland/surface/outdoors/unexplored)
"D" = (
/obj/structure/table/bronze,
/obj/item/reagent_containers/food/snacks/canned/beans{
	pixel_x = 8;
	pixel_y = 9
	},
/obj/item/trash/can/food/peaches{
	pixel_x = -6;
	pixel_y = 6
	},
/turf/open/floor/plating/asteroid/sand/sand_land_surface,
/area/sandland/surface/outdoors/unexplored)
"E" = (
/mob/living/simple_animal/hostile/retaliate/poison/snake,
/obj/effect/decal/cleanable/food/egg_smudge,
/turf/open/floor/plating/asteroid/sand/sand_land_surface,
/area/sandland/surface/outdoors/unexplored/danger)
"G" = (
/turf/open/floor/plating/asteroid/sand/sand_land_surface,
/area/sandland/surface/outdoors/unexplored/danger)
"I" = (
/obj/structure/flora/rock/pile,
/obj/structure/spider/stickyweb,
/turf/open/floor/plating/asteroid/sand/sand_land_surface,
/area/sandland/surface/outdoors/unexplored)
"L" = (
/obj/structure/closet/wardrobe/miner,
/turf/open/floor/plating/asteroid/sand/sand_land_surface,
/area/sandland/surface/outdoors/unexplored)
"M" = (
/obj/item/pda/shaftminer,
/turf/open/floor/plating/asteroid/sand/sand_land_surface,
/area/sandland/surface/outdoors/unexplored)
"N" = (
/mob/living/simple_animal/hostile/poison/giant_spider,
/turf/open/floor/plating/asteroid/sand/sand_land_surface,
/area/sandland/surface/outdoors/unexplored)
"O" = (
/mob/living/simple_animal/hostile/retaliate/poison/snake,
/turf/open/floor/plating/asteroid/sand/sand_land_surface,
/area/sandland/surface/outdoors/unexplored/danger)
"P" = (
/obj/effect/temp_visual/dir_setting/miner_death,
/turf/open/floor/plating/asteroid/sand/sand_land_surface,
/area/sandland/surface/outdoors/unexplored)
"T" = (
/obj/item/pickaxe/drill,
/turf/open/floor/plating/asteroid/sand/sand_land_surface,
/area/sandland/surface/outdoors/unexplored)
"V" = (
/obj/structure/table/bronze,
/obj/structure/spider/stickyweb,
/obj/item/toy/figure/miner,
/turf/open/floor/plating/asteroid/sand/sand_land_surface,
/area/sandland/surface/outdoors/unexplored)
"W" = (
/obj/item/stack/sheet/mineral/bananium{
	amount = 20
	},
/turf/open/floor/plating/asteroid/sand/sand_land_surface,
/area/sandland/surface/outdoors/unexplored)
"Z" = (
/obj/structure/bed/roller,
/obj/item/bedsheet/brown,
/obj/structure/spider/stickyweb,
/turf/open/floor/plating/asteroid/sand/sand_land_surface,
/area/sandland/surface/outdoors/unexplored)

(1,1,1) = {"
d
v
d
d
d
d
d
d
d
d
d
d
d
d
d
d
d
d
d
d
d
d
d
d
d
d
d
d
d
d
b
c
c
c
d
d
d
d
"}
(2,1,1) = {"
d
d
d
d
d
d
d
d
d
d
d
d
d
d
d
d
d
d
d
d
d
d
d
d
d
d
v
d
d
d
b
c
c
c
c
b
d
d
"}
(3,1,1) = {"
d
d
d
d
d
b
b
c
c
v
d
d
d
d
d
d
d
d
d
d
d
d
d
d
d
d
d
d
d
d
d
b
c
c
c
b
b
b
"}
(4,1,1) = {"
d
d
k
d
d
b
b
b
b
b
d
d
d
d
d
d
d
b
d
d
d
d
k
d
d
d
d
d
d
d
d
b
b
b
b
b
b
b
"}
(5,1,1) = {"
d
d
d
c
c
c
b
b
b
b
b
b
b
d
d
d
d
d
d
d
d
d
d
d
d
d
d
d
d
d
d
b
b
b
b
b
b
b
"}
(6,1,1) = {"
d
d
d
c
c
c
c
b
b
b
b
b
b
c
c
c
d
d
d
k
d
d
d
d
b
b
d
d
d
d
b
b
b
b
b
b
b
b
"}
(7,1,1) = {"
d
d
d
c
c
c
c
b
b
b
b
b
b
c
c
c
d
d
d
d
d
d
d
b
d
d
d
d
b
c
c
c
c
b
b
b
b
b
"}
(8,1,1) = {"
d
d
b
c
c
c
b
b
b
d
d
d
d
b
b
b
d
d
v
d
d
d
d
d
d
d
b
b
b
c
c
c
c
b
b
c
c
d
"}
(9,1,1) = {"
d
d
b
b
b
b
b
d
d
d
d
d
d
d
d
b
d
d
d
d
d
d
b
d
d
b
b
b
b
c
c
c
c
b
b
c
c
d
"}
(10,1,1) = {"
d
b
b
b
b
b
c
d
d
d
G
G
d
d
d
c
d
d
d
d
d
d
d
d
d
b
c
c
c
c
c
c
c
b
b
b
b
d
"}
(11,1,1) = {"
d
b
b
b
b
b
d
d
G
G
f
G
d
d
d
b
d
d
d
d
d
d
d
d
b
b
c
c
c
c
d
d
W
b
b
b
d
d
"}
(12,1,1) = {"
d
b
b
b
b
d
v
G
G
G
G
G
G
G
G
G
d
d
d
d
d
d
d
d
c
c
c
N
z
d
z
d
d
b
b
b
b
d
"}
(13,1,1) = {"
d
b
b
b
c
d
d
G
G
G
G
G
G
O
G
G
d
d
d
d
d
b
x
x
c
c
b
d
d
c
d
d
d
b
b
b
b
d
"}
(14,1,1) = {"
d
b
b
b
c
d
G
G
G
G
G
G
G
G
G
G
d
d
d
d
d
x
z
b
c
c
b
P
T
b
d
d
z
b
c
b
b
d
"}
(15,1,1) = {"
b
b
b
d
d
d
G
G
G
G
G
b
G
G
G
G
d
d
d
d
z
r
d
b
c
c
b
b
b
b
z
d
d
b
c
b
b
d
"}
(16,1,1) = {"
b
b
b
d
d
d
G
G
G
G
G
G
G
G
G
G
d
d
d
d
d
h
d
b
c
c
b
b
d
d
d
d
v
b
c
b
b
b
"}
(17,1,1) = {"
b
b
b
d
d
d
G
G
G
G
G
G
m
G
G
b
b
b
z
d
M
r
d
Z
b
c
b
b
d
z
d
d
b
b
c
b
c
c
"}
(18,1,1) = {"
c
c
d
d
d
G
G
b
b
E
G
G
G
G
n
b
b
b
b
d
k
x
d
d
b
b
b
d
z
B
c
b
b
c
c
b
c
c
"}
(19,1,1) = {"
c
c
d
d
d
G
G
b
b
b
G
G
G
G
b
b
c
c
b
d
d
x
V
p
l
b
b
d
d
z
b
b
b
c
c
b
c
c
"}
(20,1,1) = {"
c
c
d
d
d
G
G
b
b
b
G
f
G
G
b
b
b
d
d
d
d
b
e
d
z
b
b
I
d
d
d
b
b
c
c
b
c
c
"}
(21,1,1) = {"
c
c
b
d
d
G
G
m
G
G
G
G
G
G
d
d
d
d
d
d
d
b
b
D
d
c
c
c
b
z
i
b
b
c
c
b
b
b
"}
(22,1,1) = {"
b
b
b
d
C
G
G
G
G
G
G
G
G
G
d
d
d
d
d
d
d
b
b
b
d
d
c
c
b
d
o
b
b
c
c
b
b
b
"}
(23,1,1) = {"
d
b
b
d
d
d
f
G
G
G
G
G
G
G
b
d
d
d
d
d
d
d
b
b
d
d
z
d
z
d
b
b
c
c
b
b
b
d
"}
(24,1,1) = {"
d
b
b
c
d
d
d
d
G
G
G
G
G
d
v
d
d
d
d
d
d
d
d
b
b
c
d
d
d
d
b
c
c
b
b
b
b
d
"}
(25,1,1) = {"
d
b
b
b
b
d
d
d
G
G
G
G
G
d
d
d
d
d
d
d
d
d
d
d
d
b
b
L
j
b
c
c
c
b
d
d
d
d
"}
(26,1,1) = {"
d
b
b
b
b
d
d
d
G
G
G
G
G
d
d
d
d
d
d
d
d
d
d
d
v
d
b
b
b
b
b
d
d
d
d
d
d
d
"}
(27,1,1) = {"
d
d
b
c
c
b
b
b
G
G
G
b
b
d
d
d
d
d
d
d
d
b
d
d
d
d
d
d
d
d
d
d
d
d
d
d
v
d
"}
(28,1,1) = {"
d
d
b
c
c
b
b
b
b
b
b
b
b
d
d
d
d
d
d
d
b
b
b
d
d
d
d
k
d
d
d
d
d
d
d
d
d
d
"}
(29,1,1) = {"
d
d
d
d
d
d
b
b
b
b
b
d
d
d
d
d
d
d
d
d
c
b
b
d
d
d
d
d
d
d
d
d
d
d
d
d
d
d
"}
(30,1,1) = {"
d
d
d
d
d
d
d
d
d
d
d
d
d
d
d
d
d
d
d
d
b
b
b
b
b
b
d
d
d
d
d
d
d
b
d
d
d
d
"}
(31,1,1) = {"
d
d
d
d
d
v
d
d
d
d
d
d
d
d
d
d
d
v
d
d
b
b
b
b
b
b
b
d
d
d
d
d
d
b
d
d
d
d
"}
(32,1,1) = {"
d
d
d
d
d
d
d
d
d
d
d
d
d
d
d
d
d
d
b
b
b
b
b
b
b
b
c
d
d
d
d
d
d
d
d
d
d
d
"}
(33,1,1) = {"
d
d
d
d
d
d
d
d
d
d
d
d
d
d
d
d
d
d
d
d
d
c
c
c
b
b
c
b
d
d
b
b
d
v
d
b
b
d
"}
(34,1,1) = {"
d
d
d
d
d
d
d
d
d
d
k
d
d
d
d
d
d
d
d
d
d
d
d
d
b
b
b
b
d
d
d
d
d
d
b
b
b
d
"}
(35,1,1) = {"
d
d
d
d
d
d
d
d
d
d
d
b
b
b
d
d
d
b
b
b
d
d
d
d
b
b
b
c
d
d
d
d
d
b
b
b
b
d
"}
(36,1,1) = {"
d
d
d
d
d
d
d
d
d
d
b
c
c
c
b
b
b
b
b
b
b
d
d
b
b
b
d
d
d
d
d
d
d
b
b
b
d
d
"}
(37,1,1) = {"
d
d
k
d
d
d
d
d
d
b
c
c
c
c
b
b
b
b
b
b
c
c
b
b
b
b
d
d
d
k
d
d
d
d
d
d
d
d
"}
(38,1,1) = {"
d
d
d
d
d
d
d
d
d
d
d
c
c
c
b
d
d
d
b
b
b
b
b
d
d
d
d
d
d
d
d
d
d
d
d
d
d
d
"}
