//MAP CONVERTED BY dmm2tgm.py THIS HEADER COMMENT PREVENTS RECONVERSION, DO NOT REMOVE
"ab" = (
/turf/open/floor/plating/asteroid/sand/sand_land_surface,
/area/sandland/surface/outdoors/unexplored)
"ac" = (
/obj/item/trash/sosjerky,
/turf/open/floor/plating/asteroid/sand/sand_land_surface,
/area/sandland/surface/outdoors/unexplored)
"ad" = (
/obj/structure/flora/rock,
/turf/open/floor/plating/asteroid/sand/sand_land_surface,
/area/sandland/surface/outdoors/unexplored)
"ae" = (
/mob/living/simple_animal/hostile/lizard,
/turf/open/floor/plating/asteroid/sand/sand_land_surface,
/area/sandland/surface/outdoors/unexplored)
"af" = (
/obj/structure/reagent_dispensers/fueltank,
/turf/open/floor/plating/asteroid/sand/sand_land_surface,
/area/sandland/surface/outdoors/unexplored)
"ag" = (
/obj/item/stack/rods/fifty,
/turf/open/floor/plating/asteroid/sand/sand_land_surface,
/area/sandland/surface/outdoors/unexplored)
"ah" = (
/obj/item/stack/cable_coil{
	amount = 5
	},
/obj/item/shard{
	icon_state = "small"
	},
/turf/open/floor/plating/asteroid/sand/sand_land_surface,
/area/sandland/surface/outdoors/unexplored)
"ai" = (
/obj/item/book/random,
/turf/open/floor/plating/asteroid/sand/sand_land_surface,
/area/sandland/surface/outdoors/unexplored)
"aj" = (
/obj/structure/fluff/bus/dense,
/turf/open/floor/plating/asteroid/sand/sand_land_surface,
/area/sandland/surface/outdoors/unexplored)
"ak" = (
/obj/structure/fluff/bus/passable{
	icon_state = "wheredahoodat"
	},
/turf/open/floor/plating/asteroid/sand/sand_land_surface,
/area/sandland/surface/outdoors/unexplored)
"al" = (
/obj/effect/decal/cleanable/food/salt,
/obj/item/reagent_containers/food/condiment/saltshaker,
/turf/open/floor/plating/asteroid/sand/sand_land_surface,
/area/sandland/surface/outdoors/unexplored)
"an" = (
/obj/structure/fluff/bus/passable/seat{
	icon_state = "backseat"
	},
/obj/item/reagent_containers/food/snacks/meatball,
/turf/open/floor/plasteel/airless/dark{
	icon_state = "bus"
	},
/area/sandland/surface/outdoors/unexplored)
"ao" = (
/obj/effect/decal/cleanable/dirt,
/turf/open/floor/plasteel/airless/dark{
	icon_state = "bus"
	},
/area/sandland/surface/outdoors/unexplored)
"ap" = (
/obj/structure/fluff/bus/passable/seat{
	icon_state = "backseat";
	pixel_y = 15
	},
/turf/open/floor/plasteel/airless/dark{
	icon_state = "bus"
	},
/area/sandland/surface/outdoors/unexplored)
"aq" = (
/obj/structure/fluff/bus/passable/seat{
	icon_state = "backseat"
	},
/obj/item/reagent_containers/food/snacks/meatball,
/obj/effect/decal/cleanable/dirt,
/turf/open/floor/plasteel/airless/dark{
	icon_state = "bus"
	},
/area/sandland/surface/outdoors/unexplored)
"ar" = (
/obj/structure/fluff/bus/passable/seat{
	icon_state = "backseat"
	},
/obj/item/reagent_containers/food/snacks/grown/cherry_bomb,
/turf/open/floor/plasteel/airless/dark{
	icon_state = "bus"
	},
/area/sandland/surface/outdoors/unexplored)
"as" = (
/obj/structure/fluff/bus/passable/seat/driver{
	icon_state = "driverseat";
	pixel_y = 17
	},
/obj/effect/decal/cleanable/dirt,
/obj/item/reagent_containers/food/snacks/grown/citrus/orange,
/turf/open/floor/plasteel/airless/dark{
	icon_state = "bus"
	},
/area/sandland/surface/outdoors/unexplored)
"at" = (
/obj/structure/fluff/bus/dense{
	icon_state = "hoodtop"
	},
/turf/open/floor/plating/asteroid/sand/sand_land_surface,
/area/sandland/surface/outdoors/unexplored)
"au" = (
/obj/item/clothing/head/cone,
/turf/open/floor/plating/asteroid/sand/sand_land_surface,
/area/sandland/surface/outdoors/unexplored)
"av" = (
/obj/structure/table,
/obj/item/paicard,
/turf/open/floor/plating/asteroid/sand/sand_land_surface,
/area/sandland/surface/outdoors/unexplored)
"aw" = (
/obj/effect/decal/cleanable/oil,
/turf/open/floor/plating/asteroid/sand/sand_land_surface,
/area/sandland/surface/outdoors/unexplored)
"ax" = (
/obj/structure/fluff/bus/passable,
/obj/effect/decal/cleanable/dirt,
/turf/open/floor/plasteel/airless/dark{
	icon_state = "bus"
	},
/area/sandland/surface/outdoors/unexplored)
"ay" = (
/obj/structure/fluff/bus/passable,
/obj/item/storage/firstaid/regular,
/turf/open/floor/plasteel/airless/dark{
	icon_state = "bus"
	},
/area/sandland/surface/outdoors/unexplored)
"az" = (
/obj/structure/fluff/bus/passable,
/turf/open/floor/plasteel/airless/dark{
	icon_state = "bus"
	},
/area/sandland/surface/outdoors/unexplored)
"aA" = (
/obj/structure/fluff/bus/passable,
/obj/structure/closet/crate/freezer,
/obj/item/reagent_containers/food/snacks/meatball,
/obj/item/reagent_containers/food/snacks/meatball,
/obj/item/reagent_containers/food/snacks/meatball,
/turf/open/floor/plasteel/airless/dark{
	icon_state = "bus"
	},
/area/sandland/surface/outdoors/unexplored)
"aB" = (
/obj/structure/fluff/bus/passable,
/obj/effect/mine/sound/bwoink,
/turf/open/floor/plasteel/airless/dark{
	icon_state = "bus"
	},
/area/sandland/surface/outdoors/unexplored)
"aC" = (
/obj/structure/fluff/bus/passable,
/obj/item/reagent_containers/food/condiment/saltshaker,
/obj/effect/decal/cleanable/dirt,
/turf/open/floor/plasteel/airless/dark{
	icon_state = "bus"
	},
/area/sandland/surface/outdoors/unexplored)
"aD" = (
/obj/structure/fluff/bus/passable,
/obj/item/reagent_containers/food/snacks/meatball,
/turf/open/floor/plasteel/airless/dark{
	icon_state = "bus"
	},
/area/sandland/surface/outdoors/unexplored)
"aE" = (
/obj/structure/fluff/bus/passable{
	icon_state = "topdoor"
	},
/obj/effect/decal/cleanable/dirt,
/turf/open/floor/plasteel/airless/dark{
	icon_state = "bus"
	},
/area/sandland/surface/outdoors/unexplored)
"aF" = (
/obj/structure/fluff/bus/dense{
	icon_state = "hoodbottom"
	},
/turf/open/floor/plating/asteroid/sand/sand_land_surface,
/area/sandland/surface/outdoors/unexplored)
"aG" = (
/obj/structure/fluff/bus/passable/seat{
	icon_state = "backseat"
	},
/turf/open/floor/plating/asteroid/sand/sand_land_surface,
/area/sandland/surface/outdoors/unexplored)
"aH" = (
/obj/structure/table,
/obj/item/reagent_containers/food/drinks/coffee,
/turf/open/floor/plating/asteroid/sand/sand_land_surface,
/area/sandland/surface/outdoors/unexplored)
"aI" = (
/obj/structure/fluff/bus/dense{
	icon_state = "frontwallbottomrear"
	},
/turf/open/floor/plating/asteroid/sand/sand_land_surface,
/area/sandland/surface/outdoors/unexplored)
"aJ" = (
/obj/structure/fluff/bus/dense{
	icon_state = "frontwallbottom"
	},
/turf/open/floor/plating/asteroid/sand/sand_land_surface,
/area/sandland/surface/outdoors/unexplored)
"aK" = (
/obj/structure/fluff/bus/dense{
	icon_state = "reartire"
	},
/turf/open/floor/plating/asteroid/sand/sand_land_surface,
/area/sandland/surface/outdoors/unexplored)
"aL" = (
/obj/structure/fluff/bus/dense{
	icon_state = "frontwallbottom"
	},
/obj/effect/decal/cleanable/oil,
/turf/open/floor/plating/asteroid/sand/sand_land_surface,
/area/sandland/surface/outdoors/unexplored)
"aM" = (
/obj/structure/fluff/bus/passable{
	icon_state = "bottomdoor";
	layer = 3
	},
/turf/open/floor/plating/asteroid/sand/sand_land_surface,
/area/sandland/surface/outdoors/unexplored)
"aN" = (
/obj/structure/fluff/bus/dense{
	icon_state = "fronttire"
	},
/turf/open/floor/plating/asteroid/sand/sand_land_surface,
/area/sandland/surface/outdoors/unexplored)
"aO" = (
/obj/effect/decal/cleanable/robot_debris/old,
/turf/open/floor/plating/asteroid/sand/sand_land_surface,
/area/sandland/surface/outdoors/unexplored)
"aP" = (
/obj/item/reagent_containers/food/snacks/meatball,
/turf/open/floor/plating/asteroid/sand/sand_land_surface,
/area/sandland/surface/outdoors/unexplored)
"aQ" = (
/obj/item/reagent_containers/glass/rag,
/turf/open/floor/plating/asteroid/sand/sand_land_surface,
/area/sandland/surface/outdoors/unexplored)
"aR" = (
/obj/item/storage/toolbox/mechanical,
/obj/effect/decal/cleanable/oil,
/turf/open/floor/plating/asteroid/sand/sand_land_surface,
/area/sandland/surface/outdoors/unexplored)
"aS" = (
/obj/item/clothing/head/helmet/space,
/turf/open/floor/plating/asteroid/sand/sand_land_surface,
/area/sandland/surface/outdoors/unexplored)
"aT" = (
/obj/effect/decal/remains/human,
/turf/open/floor/plating/asteroid/sand/sand_land_surface,
/area/sandland/surface/outdoors/unexplored)
"aU" = (
/obj/structure/fluff/bus/passable/seat{
	icon_state = "backseat"
	},
/obj/effect/decal/cleanable/dirt,
/turf/open/floor/plasteel/airless/dark{
	icon_state = "bus"
	},
/area/sandland/surface/outdoors/unexplored)
"aV" = (
/obj/structure/fluff/bus/passable/seat{
	icon_state = "backseat"
	},
/obj/effect/decal/remains/human,
/turf/open/floor/plasteel/airless/dark{
	icon_state = "bus"
	},
/area/sandland/surface/outdoors/unexplored)
"aW" = (
/obj/structure/fluff/bus/passable/seat/driver{
	icon_state = "driverseat";
	pixel_y = 17
	},
/obj/effect/decal/cleanable/dirt,
/turf/open/floor/plasteel/airless/dark{
	icon_state = "bus"
	},
/area/sandland/surface/outdoors/unexplored)
"aX" = (
/obj/effect/decal/cleanable/shreds,
/turf/open/floor/plating/asteroid/sand/sand_land_surface,
/area/sandland/surface/outdoors/unexplored)
"aY" = (
/obj/effect/decal/remains/human,
/obj/item/clothing/suit/space,
/turf/open/floor/plating/asteroid/sand/sand_land_surface,
/area/sandland/surface/outdoors/unexplored)
"aZ" = (
/obj/structure/fluff/bus/passable,
/obj/effect/decal/cleanable/dirt,
/obj/item/reagent_containers/food/snacks/meatball,
/turf/open/floor/plasteel/airless/dark{
	icon_state = "bus"
	},
/area/sandland/surface/outdoors/unexplored)
"ba" = (
/obj/structure/fluff/bus/passable,
/obj/item/banhammer,
/turf/open/floor/plasteel/airless/dark{
	icon_state = "bus"
	},
/area/sandland/surface/outdoors/unexplored)
"bb" = (
/obj/item/stack/sheet/iron/fifty,
/turf/open/floor/plating/asteroid/sand/sand_land_surface,
/area/sandland/surface/outdoors/unexplored)
"dh" = (
/obj/item/stock_parts/manipulator/femto,
/turf/open/floor/plating/asteroid/sand/sand_land_surface,
/area/sandland/surface/outdoors/unexplored)
"lX" = (
/obj/structure/flora/rock/pile,
/turf/open/floor/plating/asteroid/sand/sand_land_surface,
/area/sandland/surface/outdoors/unexplored)
"Bc" = (
/turf/closed/mineral/random/high_chance,
/area/sandland/surface/outdoors/unexplored)
"OC" = (
/obj/structure/fluff/bus/passable/seat{
	icon_state = "backseat"
	},
/obj/effect/decal/cleanable/dirt,
/obj/item/reagent_containers/food/snacks/meatball,
/turf/open/floor/plasteel/airless/dark{
	icon_state = "bus"
	},
/area/sandland/surface/outdoors/unexplored)
"PY" = (
/obj/item/stack/sheet/iron/fifty{
	amount = 3
	},
/turf/open/floor/plating/asteroid/sand/sand_land_surface,
/area/sandland/surface/outdoors/unexplored)
"XA" = (
/obj/structure/fluff/bus/passable/seat{
	icon_state = "backseat"
	},
/obj/effect/decal/cleanable/dirt,
/obj/item/toy/plush/awakenedplushie,
/turf/open/floor/plasteel/airless/dark{
	icon_state = "bus"
	},
/area/sandland/surface/outdoors/unexplored)

(1,1,1) = {"
ab
ab
ab
ab
ab
Bc
Bc
ab
ab
ab
ab
au
ab
ab
ab
ab
ab
ab
"}
(2,1,1) = {"
ab
ab
Bc
Bc
Bc
Bc
Bc
Bc
ab
ab
aw
ab
ab
ab
ab
ab
PY
ab
"}
(3,1,1) = {"
ab
Bc
Bc
Bc
Bc
Bc
Bc
ab
ab
aw
ab
aP
aj
aU
az
aI
ab
ab
"}
(4,1,1) = {"
ab
Bc
Bc
Bc
Bc
ab
ab
ab
al
ab
ab
ab
aj
aU
aZ
aK
ab
ab
"}
(5,1,1) = {"
Bc
Bc
Bc
Bc
ab
ab
ab
ab
ab
ab
aw
ab
aj
aV
ba
aL
ab
ab
"}
(6,1,1) = {"
Bc
Bc
Bc
Bc
ab
ad
ab
aj
aU
ax
aI
ab
aj
OC
az
aJ
ab
ab
"}
(7,1,1) = {"
Bc
Bc
Bc
Bc
ab
ab
ab
aj
an
ay
aJ
ab
aj
aW
aE
aM
ab
ab
"}
(8,1,1) = {"
ab
Bc
Bc
ab
ab
ae
ab
aj
XA
az
aK
ab
ak
at
aF
aN
ab
ab
"}
(9,1,1) = {"
ab
Bc
Bc
ab
ab
ab
ab
aj
ao
aA
aJ
aQ
ab
aX
ab
ab
ab
ab
"}
(10,1,1) = {"
ab
Bc
ab
ab
ab
ab
lX
aj
ap
aB
aJ
ab
aR
ab
ab
au
ab
ab
"}
(11,1,1) = {"
ab
ab
ab
ab
ab
ab
ab
aj
aq
aC
aL
ab
ab
aY
ab
ab
ab
ab
"}
(12,1,1) = {"
ab
Bc
ab
ad
ab
af
ab
aj
ar
ax
aJ
ab
aS
ab
bb
ab
ab
ab
"}
(13,1,1) = {"
ab
Bc
ab
ab
ab
ag
ab
aj
aU
aD
aJ
ab
aO
ab
ab
ab
ab
ab
"}
(14,1,1) = {"
ab
Bc
Bc
ab
ab
ah
ab
aj
as
aE
aM
ab
ab
aP
ab
ab
ab
ab
"}
(15,1,1) = {"
ab
Bc
Bc
Bc
ab
ab
ai
ak
at
aF
aN
ab
ab
ab
ab
ab
lX
ab
"}
(16,1,1) = {"
ab
Bc
Bc
Bc
ab
ab
ab
ab
au
ab
ab
au
ab
ab
ab
ab
ab
ab
"}
(17,1,1) = {"
Bc
ab
Bc
Bc
ab
ab
ab
ab
ab
ab
aO
ab
ab
ab
ab
ab
ab
ab
"}
(18,1,1) = {"
ab
ab
ab
ab
Bc
ab
ab
ab
ab
ab
ab
ab
aT
ab
ab
dh
ab
ab
"}
(19,1,1) = {"
ab
ab
ab
ab
ab
ab
Bc
ab
ab
ab
ab
ab
ab
ab
ab
ad
ab
ab
"}
(20,1,1) = {"
ab
ab
lX
ab
ab
ab
ab
ab
ab
aG
ab
aS
ab
ab
ab
ab
ab
ab
"}
(21,1,1) = {"
ab
ac
ab
ab
ab
ab
ab
ab
av
aH
ab
ab
ab
ab
ab
ab
ab
ab
"}
