//MAP CONVERTED BY dmm2tgm.py THIS HEADER COMMENT PREVENTS RECONVERSION, DO NOT REMOVE
"a" = (
/turf/open/floor/plating/asteroid/sand/sand_land_surface,
/area/sandland/surface/outdoors/unexplored)
"b" = (
/turf/open/floor/plating,
/area/sandland/surface/outdoors/unexplored)
"c" = (
/turf/closed/wall,
/area/sandland/surface/outdoors/unexplored)
"d" = (
/obj/structure/lattice,
/turf/open/floor/plating/asteroid/sand/sand_land_surface,
/area/sandland/surface/outdoors/unexplored)
"e" = (
/obj/structure/lattice,
/obj/structure/lattice,
/turf/open/floor/plating/asteroid/sand/sand_land_surface,
/area/sandland/surface/outdoors/unexplored)
"f" = (
/obj/item/reagent_containers/food/drinks/soda_cans/dr_gibb{
	pixel_x = 3;
	pixel_y = 4
	},
/obj/structure/table,
/turf/open/floor/plasteel,
/area/sandland/surface/outdoors/unexplored)
"g" = (
/mob/living/simple_animal/hostile/retaliate/poison/snake,
/turf/open/floor/plating/asteroid/sand/sand_land_surface,
/area/sandland/surface/outdoors/unexplored)
"h" = (
/obj/effect/gibspawner/human,
/turf/open/floor/plating/asteroid/sand/sand_land_surface,
/area/sandland/surface/outdoors/unexplored)
"j" = (
/turf/open/floor/plasteel,
/area/sandland/surface/outdoors/unexplored)
"k" = (
/obj/structure/fluff/broken_flooring,
/turf/open/floor/plating/asteroid/sand/sand_land_surface,
/area/sandland/surface/outdoors/unexplored)
"l" = (
/obj/structure/flora/rock/pile,
/turf/open/floor/plating/asteroid/sand/sand_land_surface,
/area/sandland/surface/outdoors/unexplored)
"o" = (
/obj/structure/closet/crate,
/obj/effect/spawner/lootdrop/crate_spawner,
/obj/item/reagent_containers/food/snacks/canned/beans,
/obj/item/reagent_containers/food/snacks/canned/beans,
/obj/item/reagent_containers/food/snacks/canned/beans,
/obj/item/reagent_containers/food/snacks/canned/peaches,
/obj/item/reagent_containers/food/snacks/canned/peaches,
/turf/open/floor/plating,
/area/sandland/surface/outdoors/unexplored)
"p" = (
/obj/effect/decal/cleanable/vomit/old,
/turf/open/floor/plating,
/area/sandland/surface/outdoors/unexplored)
"q" = (
/obj/item/storage/toolbox/mechanical,
/turf/open/floor/plating/asteroid/sand/sand_land_surface,
/area/sandland/surface/outdoors/unexplored)
"r" = (
/obj/effect/decal/cleanable/blood/gibs/old,
/obj/effect/decal/cleanable/blood/gibs/limb{
	dir = 4
	},
/turf/open/floor/plating/asteroid/sand/sand_land_surface,
/area/sandland/surface/outdoors/unexplored)
"s" = (
/obj/structure/closet/secure_closet/engineering_personal,
/turf/open/floor/plating,
/area/sandland/surface/outdoors/unexplored)
"t" = (
/obj/structure/sign/departments/minsky/engineering/atmospherics,
/turf/closed/wall,
/area/sandland/surface/outdoors/unexplored)
"u" = (
/obj/structure/sign/departments/minsky/engineering/engineering,
/turf/closed/wall,
/area/sandland/surface/outdoors/unexplored)
"x" = (
/obj/structure/table/reinforced,
/obj/item/stack/sheet/iron/fifty,
/obj/item/stack/sheet/iron/fifty,
/obj/item/stack/sheet/glass/fifty,
/obj/item/stack/sheet/glass/fifty,
/turf/open/floor/plating,
/area/sandland/surface/outdoors/unexplored)
"A" = (
/obj/structure/closet/crate/engineering/electrical,
/turf/open/floor/plating,
/area/sandland/surface/outdoors/unexplored)
"B" = (
/obj/machinery/power/port_gen/pacman,
/turf/open/floor/plating,
/area/sandland/surface/outdoors/unexplored)
"C" = (
/obj/item/reagent_containers/food/snacks/egg/green,
/turf/open/floor/plating/asteroid/sand/sand_land_surface,
/area/sandland/surface/outdoors/unexplored)
"D" = (
/turf/open/floor/plating/airless,
/area/sandland/surface/outdoors/unexplored)
"E" = (
/obj/structure/sign/departments/engineering,
/turf/closed/wall,
/area/sandland/surface/outdoors/unexplored)
"H" = (
/obj/structure/sign/departments/minsky/engineering/telecommmunications,
/turf/closed/wall,
/area/sandland/surface/outdoors/unexplored)
"I" = (
/obj/item/clothing/suit/space/hardsuit/engine,
/turf/open/floor/plating,
/area/sandland/surface/outdoors/unexplored)
"L" = (
/obj/effect/decal/cleanable/robot_debris/gib,
/turf/open/floor/plating,
/area/sandland/surface/outdoors/unexplored)
"M" = (
/obj/structure/table/reinforced,
/obj/item/clothing/glasses/meson/engine{
	pixel_y = 9
	},
/obj/item/holosign_creator/engineering,
/turf/open/floor/plating,
/area/sandland/surface/outdoors/unexplored)
"O" = (
/obj/effect/spawner/lootdrop/techstorage/engineering,
/obj/structure/table/reinforced,
/turf/open/floor/plating,
/area/sandland/surface/outdoors/unexplored)
"P" = (
/obj/effect/decal/cleanable/blood/old,
/turf/open/floor/plating/asteroid/sand/sand_land_surface,
/area/sandland/surface/outdoors/unexplored)
"R" = (
/obj/structure/table/reinforced,
/obj/item/paper/guides/jobs/engi/solars,
/obj/item/storage/belt/utility/full/engi,
/turf/open/floor/plating,
/area/sandland/surface/outdoors/unexplored)
"S" = (
/obj/structure/window/fulltile/unanchored,
/obj/structure/grille/broken,
/turf/open/floor/plating,
/area/sandland/surface/outdoors/unexplored)
"T" = (
/obj/effect/decal/cleanable/food/egg_smudge,
/turf/open/floor/plating/asteroid/sand/sand_land_surface,
/area/sandland/surface/outdoors/unexplored)
"U" = (
/obj/structure/holosign/barrier/engineering,
/turf/open/floor/plating/asteroid/sand/sand_land_surface,
/area/sandland/surface/outdoors/unexplored)
"V" = (
/obj/structure/fluff/broken_flooring{
	dir = 8;
	icon_state = "plating";
	name = "broken plating"
	},
/turf/open/floor/plating/asteroid/sand/sand_land_surface,
/area/sandland/surface/outdoors/unexplored)
"W" = (
/obj/item/stack/sheet/mineral/plasma{
	amount = 37
	},
/turf/open/floor/plating,
/area/sandland/surface/outdoors/unexplored)
"Y" = (
/obj/structure/flora/rock,
/turf/open/floor/plating/asteroid/sand/sand_land_surface,
/area/sandland/surface/outdoors/unexplored)

(1,1,1) = {"
a
a
a
a
a
a
a
a
a
a
a
a
a
a
a
a
a
a
a
a
a
a
a
c
c
E
c
c
a
a
"}
(2,1,1) = {"
a
a
a
a
a
a
a
a
a
a
a
a
a
a
a
a
U
a
a
a
a
a
c
A
M
R
x
s
c
a
"}
(3,1,1) = {"
a
a
a
a
a
a
a
a
a
a
a
a
a
a
a
a
a
a
a
a
a
a
S
b
b
b
b
b
s
c
"}
(4,1,1) = {"
a
a
a
a
a
Y
a
a
a
a
a
a
a
a
a
a
a
a
a
a
a
a
a
d
b
b
I
b
O
c
"}
(5,1,1) = {"
a
a
a
a
a
a
a
a
a
a
a
a
a
a
a
a
a
a
a
a
a
a
a
d
d
d
b
b
O
c
"}
(6,1,1) = {"
a
a
a
a
a
a
a
a
a
a
a
a
a
a
a
a
a
a
a
a
a
a
q
d
d
d
b
b
O
c
"}
(7,1,1) = {"
a
a
a
a
a
a
a
a
a
a
a
a
a
a
l
a
a
a
a
a
a
a
a
a
d
d
d
p
o
c
"}
(8,1,1) = {"
a
a
a
a
g
a
a
r
a
a
U
a
a
a
a
a
a
a
a
a
a
a
a
a
d
d
d
b
b
a
"}
(9,1,1) = {"
a
a
a
a
a
C
g
P
a
a
a
a
a
a
a
a
a
a
a
a
a
a
a
d
d
a
e
d
V
a
"}
(10,1,1) = {"
a
a
a
a
a
a
T
a
a
a
a
a
a
a
a
a
a
a
a
a
a
a
a
a
a
a
a
a
a
a
"}
(11,1,1) = {"
a
a
a
a
g
a
a
a
a
a
a
a
a
a
a
a
a
a
a
a
d
d
a
a
a
a
a
a
a
a
"}
(12,1,1) = {"
a
a
a
a
a
a
a
a
a
a
a
a
a
a
a
a
a
d
d
d
d
a
a
a
a
a
a
a
a
a
"}
(13,1,1) = {"
a
a
a
a
a
a
a
a
a
a
a
a
a
a
a
d
d
d
d
d
a
a
a
a
a
a
a
a
U
a
"}
(14,1,1) = {"
a
a
a
a
a
a
a
a
a
a
a
a
a
k
j
j
j
d
d
d
a
a
a
a
a
a
a
a
a
a
"}
(15,1,1) = {"
a
a
a
l
a
a
a
a
a
a
d
d
b
b
c
j
j
b
d
a
a
a
a
a
a
a
a
a
a
a
"}
(16,1,1) = {"
a
a
a
a
a
a
a
a
a
d
d
b
b
b
t
j
j
b
d
a
a
a
a
a
a
a
a
a
a
a
"}
(17,1,1) = {"
a
a
U
a
a
a
a
a
d
d
b
b
b
b
c
f
j
b
d
a
a
a
a
h
a
a
Y
a
a
a
"}
(18,1,1) = {"
a
a
a
a
a
a
d
d
b
d
b
c
c
c
b
c
j
b
d
a
a
a
a
a
a
a
a
a
a
a
"}
(19,1,1) = {"
a
a
a
d
d
d
d
d
d
d
b
c
b
b
b
b
b
b
d
a
a
a
a
a
a
a
a
a
a
a
"}
(20,1,1) = {"
a
a
a
b
b
b
d
d
d
d
b
b
b
b
b
b
d
d
d
a
a
a
a
a
a
a
a
a
a
a
"}
(21,1,1) = {"
a
b
b
b
b
W
b
d
d
d
b
b
b
b
d
d
d
d
d
a
a
a
a
a
a
a
a
a
a
a
"}
(22,1,1) = {"
b
b
b
b
c
b
b
d
d
d
d
b
b
b
d
d
b
d
a
a
a
a
a
a
a
a
a
a
a
a
"}
(23,1,1) = {"
b
b
b
c
B
b
b
b
d
d
d
d
d
d
d
d
d
d
a
a
a
a
a
a
a
a
a
a
a
a
"}
(24,1,1) = {"
b
b
c
c
c
u
b
b
d
d
b
d
d
d
d
d
d
d
d
a
a
a
a
a
a
a
a
a
a
a
"}
(25,1,1) = {"
b
b
b
c
L
b
b
b
d
d
d
d
d
b
b
b
b
b
d
d
a
a
a
a
a
a
a
a
a
a
"}
(26,1,1) = {"
a
b
b
b
c
c
D
d
d
d
d
b
b
b
b
b
b
b
b
d
a
a
a
a
a
a
a
a
U
a
"}
(27,1,1) = {"
a
b
b
b
b
b
b
d
d
d
d
b
b
b
b
b
b
b
b
a
a
a
Y
a
a
a
a
a
a
a
"}
(28,1,1) = {"
a
a
a
b
b
b
b
d
d
d
b
b
b
b
b
H
b
b
b
b
a
a
a
a
a
a
a
a
a
a
"}
(29,1,1) = {"
a
a
a
d
d
d
d
d
d
d
b
b
b
b
c
c
c
c
b
b
a
a
a
a
a
a
a
a
a
a
"}
(30,1,1) = {"
a
a
a
a
a
d
d
b
d
d
b
b
c
c
b
c
b
b
b
a
a
a
a
a
a
a
a
a
a
a
"}
(31,1,1) = {"
a
U
a
a
a
a
d
d
d
d
b
b
b
b
b
c
b
b
a
a
a
a
a
a
a
a
a
a
l
a
"}
(32,1,1) = {"
a
a
a
a
a
a
a
d
d
d
d
d
b
b
b
b
a
a
a
a
U
a
a
a
a
a
a
a
a
a
"}
