//MAP CONVERTED BY dmm2tgm.py THIS HEADER COMMENT PREVENTS RECONVERSION, DO NOT REMOVE
"a" = (
/turf/open/floor/plating/asteroid/sand/sand_land_surface,
/area/sandland/surface/outdoors/unexplored)
"b" = (
/obj/structure/lattice,
/turf/open/floor/plating/asteroid/sand/sand_land_surface,
/area/sandland/surface/outdoors/unexplored)
"c" = (
/turf/closed/wall,
/area/ruin/unpowered/xenonest)
"d" = (
/obj/structure/alien/weeds,
/obj/structure/alien/resin/membrane,
/turf/open/floor/plating/airless,
/area/ruin/unpowered/xenonest)
"e" = (
/obj/structure/girder,
/obj/structure/alien/weeds,
/obj/structure/alien/resin/membrane,
/turf/open/floor/plating/airless,
/area/ruin/unpowered/xenonest)
"f" = (
/obj/structure/alien/weeds,
/turf/open/floor/plating/airless,
/area/ruin/unpowered/xenonest)
"g" = (
/obj/structure/alien/weeds,
/obj/structure/table_frame,
/turf/open/floor/plating/airless,
/area/ruin/unpowered/xenonest)
"h" = (
/obj/structure/alien/weeds/node,
/turf/open/floor/plating/airless,
/area/ruin/unpowered/xenonest)
"i" = (
/obj/structure/alien/weeds,
/obj/structure/bed/nest,
/turf/open/floor/plating/airless,
/area/ruin/unpowered/xenonest)
"j" = (
/obj/structure/alien/weeds,
/obj/structure/bed/nest,
/obj/effect/decal/remains/human,
/turf/open/floor/plating/airless,
/area/ruin/unpowered/xenonest)
"k" = (
/obj/structure/alien/resin/wall,
/turf/open/floor/plating/airless,
/area/ruin/unpowered/xenonest)
"l" = (
/obj/structure/alien/resin/membrane,
/turf/open/floor/plating/airless,
/area/ruin/unpowered/xenonest)
"m" = (
/obj/structure/alien/weeds,
/obj/structure/table,
/turf/open/floor/plating/airless,
/area/ruin/unpowered/xenonest)
"n" = (
/obj/structure/alien/weeds,
/obj/effect/decal/remains/robot,
/turf/open/floor/plating/airless,
/area/ruin/unpowered/xenonest)
"o" = (
/obj/structure/alien/weeds/node,
/obj/structure/table,
/turf/open/floor/plating/airless,
/area/ruin/unpowered/xenonest)
"p" = (
/obj/structure/girder,
/obj/structure/alien/resin/membrane,
/turf/open/floor/plating/airless,
/area/ruin/unpowered/xenonest)
"q" = (
/turf/open/floor/plating/airless,
/area/ruin/unpowered/xenonest)
"r" = (
/obj/structure/alien/weeds,
/obj/structure/bed/nest,
/obj/effect/decal/remains/xeno,
/turf/open/floor/plating/airless,
/area/ruin/unpowered/xenonest)
"s" = (
/obj/effect/decal/cleanable/blood/old,
/turf/open/floor/plating/airless,
/area/sandland/surface/outdoors/unexplored)
"u" = (
/obj/structure/alien/weeds,
/obj/effect/decal/cleanable/blood/gibs/limb{
	dir = 8;
	pixel_x = -6;
	pixel_y = -3
	},
/obj/effect/decal/cleanable/blood/splatter,
/turf/open/floor/plating/airless,
/area/ruin/unpowered/xenonest)
"w" = (
/obj/structure/alien/weeds,
/obj/effect/decal/cleanable/blood/footprints{
	dir = 4;
	pixel_x = 1;
	pixel_y = 9
	},
/turf/open/floor/plating/airless,
/area/ruin/unpowered/xenonest)
"x" = (
/obj/structure/girder,
/turf/open/floor/plating/airless,
/area/sandland/surface/outdoors/unexplored)
"z" = (
/obj/effect/decal/cleanable/xenoblood/xgibs/torso,
/turf/open/floor/plating/airless,
/area/sandland/surface/outdoors/unexplored)
"A" = (
/obj/structure/alien/weeds,
/obj/effect/decal/cleanable/blood/gibs/up,
/turf/open/floor/plating/airless,
/area/ruin/unpowered/xenonest)
"B" = (
/obj/structure/sign/departments/minsky/research/xenobiology,
/turf/closed/wall,
/area/ruin/unpowered/xenonest)
"C" = (
/obj/structure/alien/weeds,
/obj/effect/spawner/lootdrop/two_percent_xeno_egg_spawner,
/turf/open/floor/plating/airless,
/area/ruin/unpowered/xenonest)
"E" = (
/obj/structure/alien/weeds/node,
/obj/effect/decal/cleanable/blood/gibs/torso,
/turf/open/floor/plating/airless,
/area/ruin/unpowered/xenonest)
"H" = (
/obj/effect/decal/cleanable/xenoblood/xgibs/larva/body,
/turf/open/floor/plating/airless,
/area/sandland/surface/outdoors/unexplored)
"I" = (
/obj/structure/flora/rock,
/turf/open/floor/plating/asteroid/sand/sand_land_surface,
/area/sandland/surface/outdoors/unexplored)
"K" = (
/turf/open/floor/plating/airless,
/area/sandland/surface/outdoors/unexplored)
"M" = (
/obj/item/xenos_claw,
/turf/open/floor/plating/asteroid/sand/sand_land_surface,
/area/sandland/surface/outdoors/unexplored)
"N" = (
/obj/structure/girder,
/turf/open/floor/plating/airless,
/area/ruin/unpowered/xenonest)
"P" = (
/obj/structure/alien/weeds/node,
/obj/effect/spawner/lootdrop/two_percent_xeno_egg_spawner,
/turf/open/floor/plating/airless,
/area/ruin/unpowered/xenonest)
"Q" = (
/obj/effect/decal/remains/xeno/larva,
/turf/open/floor/plating/asteroid/sand/sand_land_surface,
/area/sandland/surface/outdoors/unexplored)
"R" = (
/obj/structure/flora/rock/pile,
/turf/open/floor/plating/asteroid/sand/sand_land_surface,
/area/sandland/surface/outdoors/unexplored)
"T" = (
/obj/structure/alien/weeds,
/obj/effect/decal/cleanable/xenoblood/xsplatter,
/turf/open/floor/plating/airless,
/area/ruin/unpowered/xenonest)
"U" = (
/obj/structure/alien/weeds,
/obj/effect/gibspawner/xeno,
/turf/open/floor/plating/airless,
/area/ruin/unpowered/xenonest)
"V" = (
/obj/effect/decal/remains/xeno,
/turf/open/floor/plating/asteroid/sand/sand_land_surface,
/area/sandland/surface/outdoors/unexplored)
"W" = (
/obj/structure/girder,
/obj/structure/alien/weeds,
/turf/open/floor/plating/airless,
/area/ruin/unpowered/xenonest)
"X" = (
/obj/structure/alien/weeds,
/obj/effect/decal/remains/xeno/larva,
/turf/open/floor/plating/airless,
/area/ruin/unpowered/xenonest)
"Y" = (
/obj/structure/alien/weeds,
/obj/effect/decal/cleanable/blood/footprints{
	dir = 4;
	pixel_x = 1;
	pixel_y = 9
	},
/obj/effect/decal/cleanable/blood/footprints{
	dir = 4;
	pixel_x = 16;
	pixel_y = 9
	},
/turf/open/floor/plating/airless,
/area/ruin/unpowered/xenonest)
"Z" = (
/turf/closed/wall,
/area/sandland/surface/outdoors/unexplored)

(1,1,1) = {"
a
a
a
a
a
a
a
a
a
a
a
a
a
a
a
a
a
a
a
a
a
a
a
a
b
b
b
a
a
"}
(2,1,1) = {"
a
a
a
a
a
a
a
a
a
a
a
a
a
a
a
a
a
a
a
a
a
a
a
b
x
x
x
Z
a
"}
(3,1,1) = {"
a
a
a
a
a
a
a
a
a
a
a
a
a
a
a
a
a
a
a
a
a
a
b
b
Z
K
K
Z
a
"}
(4,1,1) = {"
a
a
a
a
M
a
a
a
a
a
a
a
a
a
a
a
I
a
a
a
a
b
b
K
K
H
K
Z
b
"}
(5,1,1) = {"
a
a
a
a
a
a
a
a
a
a
a
a
a
V
a
a
a
a
a
a
a
a
b
K
z
K
K
Z
b
"}
(6,1,1) = {"
a
a
a
a
a
a
a
a
a
a
R
a
a
a
a
a
a
a
a
a
a
a
Z
K
K
K
K
x
b
"}
(7,1,1) = {"
a
a
a
a
a
a
a
a
a
a
a
a
a
a
a
a
a
a
a
a
a
Z
s
K
K
Z
K
b
b
"}
(8,1,1) = {"
a
a
R
a
a
a
a
I
a
a
a
a
a
a
a
a
a
a
a
a
b
b
K
K
K
b
b
b
a
"}
(9,1,1) = {"
a
a
a
a
a
a
a
a
a
a
a
a
a
a
a
a
a
a
a
a
b
b
b
b
b
b
a
a
a
"}
(10,1,1) = {"
a
a
a
a
a
b
b
a
a
a
a
a
a
a
a
a
a
a
a
b
b
a
b
b
b
a
a
a
a
"}
(11,1,1) = {"
a
a
a
a
b
b
b
b
b
a
a
a
b
b
b
b
b
b
a
a
a
a
a
a
a
a
a
a
a
"}
(12,1,1) = {"
a
a
a
b
b
b
b
k
c
a
a
b
b
b
b
b
b
a
a
a
a
a
a
a
a
a
a
a
a
"}
(13,1,1) = {"
a
a
a
b
b
b
k
f
f
e
a
c
d
N
b
b
a
a
a
a
a
a
a
a
a
a
a
a
a
"}
(14,1,1) = {"
a
a
b
b
b
k
f
f
f
c
c
c
f
c
b
a
a
a
a
a
a
a
a
a
a
a
a
a
a
"}
(15,1,1) = {"
a
a
b
b
b
k
f
i
f
c
m
m
U
c
b
a
a
a
a
a
a
a
a
a
a
a
a
a
a
"}
(16,1,1) = {"
a
a
b
b
e
f
P
f
f
W
f
h
f
c
c
B
c
a
a
a
a
a
a
a
a
a
a
a
a
"}
(17,1,1) = {"
a
a
a
c
f
f
f
f
f
c
j
f
f
c
h
d
W
b
a
a
a
a
a
a
a
a
I
a
a
"}
(18,1,1) = {"
a
a
a
c
c
c
c
c
f
c
f
j
f
c
f
f
l
b
b
a
a
a
a
a
a
a
a
a
a
"}
(19,1,1) = {"
a
a
b
B
g
f
f
f
f
C
f
f
f
f
f
f
f
l
K
b
a
a
Q
a
a
a
a
a
a
"}
(20,1,1) = {"
a
b
b
c
h
f
f
f
f
f
f
f
f
f
f
f
r
d
b
b
a
a
a
a
a
a
a
a
a
"}
(21,1,1) = {"
b
b
b
c
c
c
c
c
Y
c
f
T
f
c
f
f
f
d
b
b
a
a
a
a
a
a
a
a
a
"}
(22,1,1) = {"
b
b
b
d
X
f
f
u
w
c
f
f
i
c
i
g
d
b
b
a
a
a
a
a
a
a
a
a
a
"}
(23,1,1) = {"
b
b
b
c
i
A
E
f
f
c
f
P
f
c
c
c
h
b
b
a
a
R
a
a
a
a
a
a
a
"}
(24,1,1) = {"
a
a
b
c
j
f
f
f
f
W
i
f
f
k
q
b
b
b
b
a
a
a
a
a
a
a
a
R
a
"}
(25,1,1) = {"
a
a
b
c
c
c
f
f
f
c
f
i
k
q
N
b
b
b
a
a
a
a
a
a
a
a
a
a
a
"}
(26,1,1) = {"
a
a
a
a
b
c
c
f
n
c
B
c
q
b
b
b
a
a
a
a
a
a
a
a
a
a
a
a
a
"}
(27,1,1) = {"
a
a
a
a
b
b
c
m
o
c
a
a
b
b
a
a
a
a
a
a
a
a
a
a
a
a
a
a
a
"}
(28,1,1) = {"
a
a
a
a
b
b
l
l
p
N
a
a
a
a
a
a
a
a
a
a
a
a
a
a
a
a
a
a
a
"}
(29,1,1) = {"
a
a
I
a
b
b
b
b
b
b
a
a
a
a
a
a
a
a
a
I
a
a
a
a
a
a
a
a
a
"}
(30,1,1) = {"
a
a
a
a
b
b
b
b
b
a
a
a
a
a
a
a
a
a
a
a
a
a
a
a
a
a
a
a
a
"}
(31,1,1) = {"
a
a
a
a
a
b
b
b
a
a
a
a
a
a
a
a
a
a
a
a
a
a
a
a
a
a
a
a
a
"}
