//MAP CONVERTED BY dmm2tgm.py THIS HEADER COMMENT PREVENTS RECONVERSION, DO NOT REMOVE
"c" = (
/turf/open/floor/plating/asteroid/sand/sand_land_surface,
/area/sandland/surface/outdoors/unexplored)
"f" = (
/obj/structure/flora/rock,
/turf/open/floor/plating/asteroid/sand/sand_land_surface,
/area/sandland/surface/outdoors/unexplored)
"k" = (
/obj/item/clothing/under/color/random,
/turf/open/floor/plating/asteroid/sand/sand_land_surface,
/area/sandland/surface/outdoors/unexplored)
"m" = (
/obj/effect/mob_spawn/human/corpse/cargo_tech,
/turf/open/floor/plating/asteroid/sand/sand_land_surface,
/area/sandland/surface/outdoors/unexplored)
"n" = (
/turf/closed/mineral/random/high_chance,
/area/sandland/surface/outdoors/unexplored)
"s" = (
/turf/closed/mineral/random/low_chance,
/area/sandland/surface/outdoors/unexplored)
"z" = (
/obj/structure/statue/sandstone/assistant,
/turf/open/floor/plating/asteroid/sand/sand_land_surface,
/area/sandland/surface/outdoors/unexplored)
"S" = (
/obj/item/pickaxe,
/turf/open/floor/plating/asteroid/sand/sand_land_surface,
/area/sandland/surface/outdoors/unexplored)
"V" = (
/turf/closed/mineral/random/high_chance/volcanic,
/area/sandland/surface/outdoors/unexplored)
"X" = (
/obj/structure/flora/rock/pile,
/turf/open/floor/plating/asteroid/sand/sand_land_surface,
/area/sandland/surface/outdoors/unexplored)
"Z" = (
/obj/structure/geyser/random,
/turf/open/floor/plating/asteroid/sand/sand_land_surface,
/area/sandland/surface/outdoors/unexplored)

(1,1,1) = {"
c
c
c
c
c
c
c
c
c
c
c
V
V
V
V
c
c
"}
(2,1,1) = {"
f
c
c
c
c
c
c
c
c
V
V
V
V
c
c
c
c
"}
(3,1,1) = {"
c
c
c
c
c
c
c
c
c
V
V
V
c
c
c
c
c
"}
(4,1,1) = {"
c
c
c
c
c
X
c
c
n
n
n
c
c
c
c
c
c
"}
(5,1,1) = {"
c
c
c
V
c
c
c
n
n
n
c
c
c
c
c
c
c
"}
(6,1,1) = {"
c
V
V
V
c
c
V
S
c
c
c
c
X
c
c
c
c
"}
(7,1,1) = {"
c
c
V
c
c
c
c
c
c
c
c
c
c
c
c
c
c
"}
(8,1,1) = {"
c
V
c
c
c
c
c
c
z
c
c
c
c
c
c
c
c
"}
(9,1,1) = {"
c
V
c
c
c
c
c
c
c
c
c
Z
c
s
c
c
c
"}
(10,1,1) = {"
c
V
V
c
c
c
f
c
c
c
c
c
c
c
c
s
c
"}
(11,1,1) = {"
c
c
c
c
s
c
c
c
m
n
n
c
c
c
c
c
c
"}
(12,1,1) = {"
c
c
c
c
c
c
c
c
k
n
n
c
c
f
c
c
c
"}
(13,1,1) = {"
c
X
c
c
c
c
c
c
n
c
c
c
c
c
s
c
c
"}
(14,1,1) = {"
c
c
c
c
c
c
c
c
c
c
c
c
c
c
c
c
c
"}
(15,1,1) = {"
c
c
c
c
c
c
c
c
c
c
c
c
c
c
c
c
c
"}
