"a" = (/turf/closed/wall/mineral/plastitanium,/area/shuttle/arrival)
"c" = (/turf/template_noop,/area/template_noop)
"i" = (/obj/structure/chair/comfy/shuttle,/turf/open/floor/mineral/plastitanium,/area/shuttle/arrival)
"k" = (/obj/structure/shuttle/engine/heater{dir = 8},/obj/structure/window/reinforced{dir = 4},/turf/open/floor/plating/airless,/area/shuttle/arrival)
"l" = (/obj/structure/closet/wardrobe/red{name = "uniform wardrobe"},/turf/open/floor/mineral/plastitanium,/area/shuttle/arrival)
"m" = (/turf/open/floor/mineral/plastitanium,/area/shuttle/arrival)
"n" = (/obj/structure/table,/obj/item/storage/fancy/donut_box,/turf/open/floor/mineral/plastitanium,/area/shuttle/arrival)
"o" = (/obj/machinery/light,/obj/structure/table,/turf/open/floor/mineral/plastitanium,/area/shuttle/arrival)
"x" = (/obj/structure/chair/comfy/shuttle{dir = 1},/turf/open/floor/mineral/plastitanium,/area/shuttle/arrival)
"z" = (/obj/structure/table,/obj/item/storage/firstaid/regular,/turf/open/floor/mineral/plastitanium,/area/shuttle/arrival)
"A" = (/obj/structure/closet/emcloset,/obj/machinery/light,/turf/open/floor/mineral/plastitanium,/area/shuttle/arrival)
"B" = (/obj/machinery/light{dir = 1},/obj/structure/table,/turf/open/floor/mineral/plastitanium,/area/shuttle/arrival)
"E" = (/obj/machinery/door/airlock/survival_pod,/obj/structure/fans/tiny,/turf/open/floor/plating/airless,/area/shuttle/arrival)
"J" = (/obj/structure/closet/emcloset,/obj/machinery/light{dir = 1},/turf/open/floor/mineral/plastitanium,/area/shuttle/arrival)
"L" = (/obj/structure/shuttle/engine/propulsion{dir = 8},/turf/open/floor/plating/airless,/area/shuttle/arrival)
"N" = (/obj/structure/table,/turf/open/floor/mineral/plastitanium,/area/shuttle/arrival)
"O" = (/obj/machinery/door/airlock/survival_pod/glass,/turf/open/floor/mineral/plastitanium,/area/shuttle/arrival)
"R" = (/obj/structure/chair/comfy/shuttle{dir = 4},/obj/machinery/light/small{dir = 8},/turf/open/floor/mineral/plastitanium,/area/shuttle/arrival)
"U" = (/turf/open/floor/mineral/plastitanium/red,/area/shuttle/arrival)
"Y" = (/obj/effect/spawner/structure/window/plastitanium,/turf/open/floor/plating,/area/shuttle/arrival)

(1,1,1) = {"
aaEaYYYYaaEaccc
LkUJiiiiiBUaaaa
LkUUUUUUUUUaRmY
LkUznlllNlUOmmY
LkUUUUUUUUUaRmY
LkUAxxxxxoUaaaa
aaEaYYYYaaEaccc
"}
